1 2 3 4 5
3 4 5 6 7
5 6 7 8 9
8 9 0 9 8
w e r t y