www www www www www www www www www www www www www www www www
www aaa aaa aaa aaa aaa aaa aaa aaa aaa aaa aaa aaa aaa aaa www
www aaa aaa aaa aaa aaa aaa aaa aaa aaa aaa aaa aaa aaa aaa www
www aaa aaa aaa aaa aaa aaa aaa aaa aaa aaa aaa aaa aaa aaa www
www aaa aaa aaa aaa aaa aaa aaa aaa aaa aaa aaa aaa aaa aaa www
www aaa aaa aaa aaa aaa aaa aaa aaa aaa aaa aaa aaa aaa aaa aaa
www aaa aaa aaa aaa aaa aaa aaa aaa aaa aaa aaa aaa aaa aaa aaa
www aaa aaa aaa aaa aaa aaa aaa aaa aaa aaa aaa aaa aaa aaa www
www aaa aaa aaa aaa aaa aaa aaa aaa aaa aaa aaa aaa aaa aaa www
www aaa aaa aaa aaa aaa aaa aaa aaa aaa aaa aaa aaa aaa aaa www
www aaa aaa aaa aaa aaa aaa aaa aaa aaa aaa aaa aaa aaa aaa www
www www www www www www www www www www www www www www www www